//MAP CONVERTED BY dmm2tgm.py THIS HEADER COMMENT PREVENTS RECONVERSION, DO NOT REMOVE
"a" = (
/turf/exterior/wall/ice,
/area/adytum/third)
"b" = (
/turf/simulated/wall/concrete,
/area/adytum/third)
"c" = (
/obj/abstract/landmark/latejoin/cyborg,
/turf/simulated/floor/planetary,
/area/adytum/second)
"f" = (
/obj/abstract/landmark/latejoin/observer,
/turf/simulated/floor/planetary,
/area/adytum/third)
"v" = (
/turf/exterior/wall/ice,
/area/adytum/first)
"A" = (
/turf/simulated/wall/concrete,
/area/adytum/first)
"E" = (
/turf/simulated/wall/concrete,
/area/adytum/second)
"G" = (
/turf/simulated/floor/planetary,
/area/adytum/third)
"I" = (
/obj/abstract/landmark/latejoin,
/turf/simulated/floor/planetary,
/area/adytum/third)
"J" = (
/turf/simulated/floor/planetary,
/area/adytum/first)
"S" = (
/obj/item/flashlight,
/turf/simulated/floor/planetary,
/area/adytum/third)
"U" = (
/obj/abstract/landmark/latejoin/cryo,
/turf/simulated/floor/planetary,
/area/adytum/third)
"X" = (
/turf/exterior/wall/ice,
/area/adytum/second)
"Y" = (
/turf/simulated/floor/planetary,
/area/adytum/second)

(1,1,1) = {"
v
v
v
v
v
v
v
v
v
v
v
v
v
v
v
v
v
v
v
v
v
v
v
v
v
v
v
v
v
a
a
a
a
a
a
a
a
a
a
a
a
a
a
a
a
a
a
a
a
a
a
a
"}
(2,1,1) = {"
v
A
A
A
A
A
A
A
A
A
A
A
A
A
A
A
A
A
A
A
A
A
A
A
A
A
A
A
A
b
b
b
b
b
b
b
b
b
b
b
b
b
b
b
b
b
b
b
b
b
b
a
"}
(3,1,1) = {"
v
A
J
J
J
J
J
J
J
J
J
J
J
J
J
J
J
J
J
J
J
J
J
J
J
J
J
J
J
G
G
G
G
G
G
G
G
G
G
G
G
G
G
G
G
G
G
G
G
G
b
a
"}
(4,1,1) = {"
v
A
J
J
J
J
J
J
J
J
J
J
J
J
J
J
J
J
J
J
J
J
J
J
J
J
J
J
J
G
G
G
G
G
G
G
G
G
G
G
G
G
G
G
G
G
G
G
G
G
b
a
"}
(5,1,1) = {"
v
A
J
J
J
J
J
J
J
J
J
J
J
J
J
J
J
J
J
J
J
J
J
J
J
J
J
J
J
G
G
G
G
G
G
G
G
G
G
G
G
G
G
G
G
G
G
G
G
G
b
a
"}
(6,1,1) = {"
v
A
J
J
J
J
J
J
J
J
J
J
J
J
J
J
J
J
J
J
J
J
J
J
J
J
J
J
J
G
G
G
G
G
G
G
G
G
G
G
G
G
G
G
G
G
G
G
G
G
b
a
"}
(7,1,1) = {"
v
A
J
J
J
J
J
J
J
J
J
J
J
J
J
J
J
J
J
J
J
J
J
J
J
J
J
J
J
G
G
G
G
G
G
G
G
G
G
G
G
G
G
G
G
G
G
G
G
G
b
a
"}
(8,1,1) = {"
v
A
J
J
J
J
J
J
J
J
J
J
J
J
J
J
J
J
J
J
J
J
J
J
J
J
J
J
J
G
G
G
G
G
G
G
G
G
G
G
G
G
G
G
G
G
G
G
G
G
b
a
"}
(9,1,1) = {"
v
A
J
J
J
J
J
J
J
J
J
J
J
J
J
J
J
J
J
J
J
J
J
J
J
J
J
J
J
G
G
G
G
G
G
G
G
G
G
G
G
G
G
G
G
G
G
G
G
G
b
a
"}
(10,1,1) = {"
v
A
J
J
J
J
J
J
J
J
J
J
J
J
J
J
J
J
J
J
J
J
J
J
J
J
J
J
J
G
G
G
G
G
G
G
G
G
G
G
G
G
G
G
G
G
G
G
G
G
b
a
"}
(11,1,1) = {"
v
A
J
J
J
J
J
J
J
J
J
J
J
J
J
J
J
J
J
J
J
J
J
J
J
J
J
J
J
G
G
G
G
G
G
G
G
G
G
G
G
G
G
G
G
G
G
G
G
G
b
a
"}
(12,1,1) = {"
v
A
J
J
J
J
J
J
J
J
J
J
J
J
J
J
J
J
J
J
J
J
J
J
J
J
J
J
J
G
G
G
G
G
G
G
G
G
G
G
G
G
G
G
G
G
G
G
G
G
b
a
"}
(13,1,1) = {"
v
A
J
J
J
J
J
J
J
J
J
J
J
J
J
J
J
J
J
J
J
J
J
J
J
J
J
J
J
G
G
G
G
G
G
G
G
G
G
G
G
G
G
G
G
G
G
G
G
G
b
a
"}
(14,1,1) = {"
v
A
J
J
J
J
J
J
J
J
J
J
J
J
J
J
J
J
J
J
J
J
J
J
J
J
J
J
J
G
G
G
G
G
G
G
G
G
G
G
G
G
G
G
G
G
G
G
G
G
b
a
"}
(15,1,1) = {"
v
A
J
J
J
J
J
J
J
J
J
J
J
J
J
J
J
J
J
J
J
J
J
J
J
J
J
J
J
G
G
G
G
G
G
G
G
G
G
G
G
G
G
G
G
G
G
G
G
G
b
a
"}
(16,1,1) = {"
v
A
J
J
J
J
J
J
J
J
J
J
J
J
J
J
J
J
J
J
J
J
J
J
J
J
J
J
J
G
G
G
G
G
G
G
G
G
G
G
G
G
G
G
G
G
G
G
G
G
b
a
"}
(17,1,1) = {"
v
A
J
J
J
J
J
J
J
J
J
J
J
J
J
J
J
J
J
J
J
J
J
J
J
J
J
J
J
G
G
G
G
G
G
G
G
G
G
G
G
G
G
G
G
G
G
G
G
G
b
a
"}
(18,1,1) = {"
v
A
J
J
J
J
J
J
J
J
J
J
J
J
J
J
J
J
J
J
J
J
J
J
J
J
J
J
J
G
G
G
G
G
G
G
G
G
G
G
G
G
G
G
G
G
G
G
G
G
b
a
"}
(19,1,1) = {"
v
A
J
J
J
J
J
J
J
J
J
J
J
J
J
J
J
J
J
J
J
J
J
J
J
J
J
J
J
G
G
G
G
G
G
G
G
G
G
G
G
G
G
G
G
G
G
G
G
G
b
a
"}
(20,1,1) = {"
v
A
J
J
J
J
J
J
J
J
J
J
J
J
J
J
J
J
J
J
J
J
J
J
J
J
J
J
J
G
G
G
G
G
G
G
G
G
G
G
G
G
G
G
G
G
G
G
G
G
b
a
"}
(21,1,1) = {"
v
A
J
J
J
J
J
J
J
J
J
J
J
J
J
J
J
J
J
J
J
J
J
J
J
J
J
J
J
G
G
G
G
G
G
G
G
G
G
G
G
G
G
G
G
G
G
G
G
G
b
a
"}
(22,1,1) = {"
v
A
J
J
J
J
J
J
J
J
J
J
J
J
J
J
J
J
J
J
J
J
J
J
J
J
J
J
J
G
G
G
G
G
G
G
G
G
G
G
G
G
G
G
G
G
G
G
G
G
b
a
"}
(23,1,1) = {"
v
A
J
J
J
J
J
J
J
J
J
J
J
J
J
J
J
J
J
J
J
J
J
J
J
J
J
J
J
G
G
G
G
G
G
G
G
G
G
G
G
G
G
G
G
G
G
G
G
G
b
a
"}
(24,1,1) = {"
v
A
J
J
J
J
J
J
J
J
J
J
J
J
J
J
J
J
J
J
J
J
J
J
J
J
J
J
J
G
G
G
G
G
G
G
G
G
G
G
G
G
G
G
G
G
G
G
G
G
b
a
"}
(25,1,1) = {"
v
A
J
J
J
J
J
J
J
J
J
J
J
J
J
J
J
J
J
J
J
J
J
J
J
J
J
J
J
G
G
G
G
G
G
G
G
G
G
G
G
G
G
G
G
G
G
G
G
G
b
a
"}
(26,1,1) = {"
v
A
J
J
J
J
J
J
J
J
J
J
J
J
J
J
J
J
J
J
J
J
J
J
J
J
J
J
J
G
G
G
G
G
G
G
G
G
G
G
G
G
G
G
G
G
G
G
G
G
b
a
"}
(27,1,1) = {"
v
A
J
J
J
J
J
J
J
J
J
J
J
J
J
J
J
J
J
J
J
J
J
J
J
J
J
J
J
G
G
G
G
G
G
G
G
G
G
G
G
G
G
G
G
G
G
G
G
G
b
a
"}
(28,1,1) = {"
v
A
J
J
J
J
J
J
J
J
J
J
J
J
J
J
J
J
J
J
J
J
J
J
J
J
J
J
J
G
S
S
S
G
G
G
G
G
G
G
G
G
G
G
G
G
G
G
G
G
b
a
"}
(29,1,1) = {"
v
A
J
J
J
J
J
J
J
J
J
J
J
J
J
J
J
J
J
J
J
J
J
J
J
J
J
J
J
G
G
I
G
G
G
G
G
G
G
G
G
G
G
G
G
G
G
G
G
G
b
a
"}
(30,1,1) = {"
v
A
J
J
J
J
J
J
J
J
J
J
J
J
J
J
J
J
J
J
J
J
J
J
J
J
J
J
J
G
S
S
S
G
G
G
G
G
G
G
G
G
G
G
G
G
G
G
G
G
b
a
"}
(31,1,1) = {"
v
A
J
J
J
J
J
J
J
J
J
J
J
J
J
J
J
J
J
J
J
J
J
J
J
J
J
J
J
G
G
U
G
G
G
G
G
G
G
G
G
G
G
G
G
G
G
G
G
G
b
a
"}
(32,1,1) = {"
v
A
J
J
J
J
J
J
J
J
J
J
J
J
J
J
J
J
J
J
J
J
J
J
J
J
J
J
J
f
S
S
S
G
G
G
G
G
G
G
G
G
G
G
G
G
G
G
G
G
b
a
"}
(33,1,1) = {"
X
E
Y
Y
Y
Y
Y
Y
Y
Y
Y
Y
Y
Y
Y
Y
Y
Y
Y
Y
Y
Y
Y
Y
Y
Y
Y
Y
Y
Y
Y
c
Y
Y
Y
Y
Y
Y
Y
Y
Y
Y
Y
Y
Y
Y
Y
Y
Y
Y
E
X
"}
(34,1,1) = {"
X
E
Y
Y
Y
Y
Y
Y
Y
Y
Y
Y
Y
Y
Y
Y
Y
Y
Y
Y
Y
Y
Y
Y
Y
Y
Y
Y
Y
Y
Y
Y
Y
Y
Y
Y
Y
Y
Y
Y
Y
Y
Y
Y
Y
Y
Y
Y
Y
Y
E
X
"}
(35,1,1) = {"
X
E
Y
Y
Y
Y
Y
Y
Y
Y
Y
Y
Y
Y
Y
Y
Y
Y
Y
Y
Y
Y
Y
Y
Y
Y
Y
Y
Y
Y
Y
Y
Y
Y
Y
Y
Y
Y
Y
Y
Y
Y
Y
Y
Y
Y
Y
Y
Y
Y
E
X
"}
(36,1,1) = {"
X
E
Y
Y
Y
Y
Y
Y
Y
Y
Y
Y
Y
Y
Y
Y
Y
Y
Y
Y
Y
Y
Y
Y
Y
Y
Y
Y
Y
Y
Y
Y
Y
Y
Y
Y
Y
Y
Y
Y
Y
Y
Y
Y
Y
Y
Y
Y
Y
Y
E
X
"}
(37,1,1) = {"
X
E
Y
Y
Y
Y
Y
Y
Y
Y
Y
Y
Y
Y
Y
Y
Y
Y
Y
Y
Y
Y
Y
Y
Y
Y
Y
Y
Y
Y
Y
Y
Y
Y
Y
Y
Y
Y
Y
Y
Y
Y
Y
Y
Y
Y
Y
Y
Y
Y
E
X
"}
(38,1,1) = {"
X
E
Y
Y
Y
Y
Y
Y
Y
Y
Y
Y
Y
Y
Y
Y
Y
Y
Y
Y
Y
Y
Y
Y
Y
Y
Y
Y
Y
Y
Y
Y
Y
Y
Y
Y
Y
Y
Y
Y
Y
Y
Y
Y
Y
Y
Y
Y
Y
Y
E
X
"}
(39,1,1) = {"
X
E
Y
Y
Y
Y
Y
Y
Y
Y
Y
Y
Y
Y
Y
Y
Y
Y
Y
Y
Y
Y
Y
Y
Y
Y
Y
Y
Y
Y
Y
Y
Y
Y
Y
Y
Y
Y
Y
Y
Y
Y
Y
Y
Y
Y
Y
Y
Y
Y
E
X
"}
(40,1,1) = {"
X
E
Y
Y
Y
Y
Y
Y
Y
Y
Y
Y
Y
Y
Y
Y
Y
Y
Y
Y
Y
Y
Y
Y
Y
Y
Y
Y
Y
Y
Y
Y
Y
Y
Y
Y
Y
Y
Y
Y
Y
Y
Y
Y
Y
Y
Y
Y
Y
Y
E
X
"}
(41,1,1) = {"
X
E
Y
Y
Y
Y
Y
Y
Y
Y
Y
Y
Y
Y
Y
Y
Y
Y
Y
Y
Y
Y
Y
Y
Y
Y
Y
Y
Y
Y
Y
Y
Y
Y
Y
Y
Y
Y
Y
Y
Y
Y
Y
Y
Y
Y
Y
Y
Y
Y
E
X
"}
(42,1,1) = {"
X
E
Y
Y
Y
Y
Y
Y
Y
Y
Y
Y
Y
Y
Y
Y
Y
Y
Y
Y
Y
Y
Y
Y
Y
Y
Y
Y
Y
Y
Y
Y
Y
Y
Y
Y
Y
Y
Y
Y
Y
Y
Y
Y
Y
Y
Y
Y
Y
Y
E
X
"}
(43,1,1) = {"
X
E
Y
Y
Y
Y
Y
Y
Y
Y
Y
Y
Y
Y
Y
Y
Y
Y
Y
Y
Y
Y
Y
Y
Y
Y
Y
Y
Y
Y
Y
Y
Y
Y
Y
Y
Y
Y
Y
Y
Y
Y
Y
Y
Y
Y
Y
Y
Y
Y
E
X
"}
(44,1,1) = {"
X
E
Y
Y
Y
Y
Y
Y
Y
Y
Y
Y
Y
Y
Y
Y
Y
Y
Y
Y
Y
Y
Y
Y
Y
Y
Y
Y
Y
Y
Y
Y
Y
Y
Y
Y
Y
Y
Y
Y
Y
Y
Y
Y
Y
Y
Y
Y
Y
Y
E
X
"}
(45,1,1) = {"
X
E
Y
Y
Y
Y
Y
Y
Y
Y
Y
Y
Y
Y
Y
Y
Y
Y
Y
Y
Y
Y
Y
Y
Y
Y
Y
Y
Y
Y
Y
Y
Y
Y
Y
Y
Y
Y
Y
Y
Y
Y
Y
Y
Y
Y
Y
Y
Y
Y
E
X
"}
(46,1,1) = {"
X
E
Y
Y
Y
Y
Y
Y
Y
Y
Y
Y
Y
Y
Y
Y
Y
Y
Y
Y
Y
Y
Y
Y
Y
Y
Y
Y
Y
Y
Y
Y
Y
Y
Y
Y
Y
Y
Y
Y
Y
Y
Y
Y
Y
Y
Y
Y
Y
Y
E
X
"}
(47,1,1) = {"
X
E
Y
Y
Y
Y
Y
Y
Y
Y
Y
Y
Y
Y
Y
Y
Y
Y
Y
Y
Y
Y
Y
Y
Y
Y
Y
Y
Y
Y
Y
Y
Y
Y
Y
Y
Y
Y
Y
Y
Y
Y
Y
Y
Y
Y
Y
Y
Y
Y
E
X
"}
(48,1,1) = {"
X
E
Y
Y
Y
Y
Y
Y
Y
Y
Y
Y
Y
Y
Y
Y
Y
Y
Y
Y
Y
Y
Y
Y
Y
Y
Y
Y
Y
Y
Y
Y
Y
Y
Y
Y
Y
Y
Y
Y
Y
Y
Y
Y
Y
Y
Y
Y
Y
Y
E
X
"}
(49,1,1) = {"
X
E
Y
Y
Y
Y
Y
Y
Y
Y
Y
Y
Y
Y
Y
Y
Y
Y
Y
Y
Y
Y
Y
Y
Y
Y
Y
Y
Y
Y
Y
Y
Y
Y
Y
Y
Y
Y
Y
Y
Y
Y
Y
Y
Y
Y
Y
Y
Y
Y
E
X
"}
(50,1,1) = {"
X
E
Y
Y
Y
Y
Y
Y
Y
Y
Y
Y
Y
Y
Y
Y
Y
Y
Y
Y
Y
Y
Y
Y
Y
Y
Y
Y
Y
Y
Y
Y
Y
Y
Y
Y
Y
Y
Y
Y
Y
Y
Y
Y
Y
Y
Y
Y
Y
Y
E
X
"}
(51,1,1) = {"
X
E
E
E
E
E
E
E
E
E
E
E
E
E
E
E
E
E
E
E
E
E
E
E
E
E
E
E
E
E
E
E
E
E
E
E
E
E
E
E
E
E
E
E
E
E
E
E
E
E
E
X
"}
(52,1,1) = {"
X
X
X
X
X
X
X
X
X
X
X
X
X
X
X
X
X
X
X
X
X
X
X
X
X
X
X
X
X
X
X
X
X
X
X
X
X
X
X
X
X
X
X
X
X
X
X
X
X
X
X
X
"}
