//MAP CONVERTED BY dmm2tgm.py THIS HEADER COMMENT PREVENTS RECONVERSION, DO NOT REMOVE
"a" = (
/turf/simulated/floor/planetary/wasteland,
/area/vaultcity/first)
"i" = (
/turf/simulated/floor/planetary/floor/red,
/area/vaultcity/first)
"j" = (
/turf/simulated/floor/planetary/floor/green,
/area/vaultcity/first)
"l" = (
/turf/simulated/floor/planetary/floor/blue,
/area/vaultcity/first)
"n" = (
/obj/abstract/level_data_spawner/main_level{
	name = "Vault City Test Level"
	},
/turf/simulated/wall,
/area/vaultcity/first)
"q" = (
/obj/abstract/landmark/latejoin/observer,
/turf/simulated/floor/planetary/wasteland,
/area/vaultcity/first)
"z" = (
/turf/simulated/wall,
/area/vaultcity/first)
"I" = (
/turf/simulated/floor/planetary/floor/dark,
/area/vaultcity/first)
"J" = (
/obj/abstract/landmark/latejoin/cryo,
/turf/simulated/floor/planetary/wasteland,
/area/vaultcity/first)
"K" = (
/obj/abstract/landmark/latejoin/cyborg,
/turf/simulated/floor/planetary/wasteland,
/area/vaultcity/first)
"U" = (
/turf/simulated/floor/planetary/floor/white,
/area/vaultcity/first)
"X" = (
/obj/abstract/map_data/vaultcity,
/turf/simulated/wall,
/area/vaultcity/first)
"Z" = (
/obj/abstract/landmark/latejoin,
/turf/simulated/floor/planetary/wasteland,
/area/vaultcity/first)

(1,1,1) = {"
z
z
z
z
z
z
z
z
z
z
z
z
z
z
z
z
z
z
z
z
z
z
z
z
z
z
z
z
n
X
"}
(2,1,1) = {"
z
l
l
l
l
l
l
l
l
l
l
l
a
a
a
a
a
a
a
a
a
a
a
a
a
q
K
J
Z
z
"}
(3,1,1) = {"
z
l
l
l
l
l
l
l
l
l
l
l
a
a
a
a
a
a
a
a
a
a
a
a
a
a
a
a
a
z
"}
(4,1,1) = {"
z
l
l
l
l
l
l
l
l
l
l
l
a
a
a
a
a
a
a
a
a
a
a
a
a
a
a
a
a
z
"}
(5,1,1) = {"
z
l
l
l
l
l
l
l
l
l
l
l
a
a
a
a
a
a
a
a
a
a
a
a
a
a
a
a
a
z
"}
(6,1,1) = {"
z
l
l
l
l
l
l
l
l
l
l
l
a
a
a
a
a
a
a
a
a
a
a
a
a
a
a
a
a
z
"}
(7,1,1) = {"
z
l
l
l
l
l
l
l
l
l
l
l
a
a
a
a
a
a
a
a
a
a
a
a
a
a
a
a
a
z
"}
(8,1,1) = {"
z
l
l
l
l
l
l
l
l
l
l
l
a
a
a
a
a
a
a
a
a
a
a
a
a
a
a
a
a
z
"}
(9,1,1) = {"
z
l
l
l
l
l
l
l
l
l
l
l
a
a
a
a
a
a
a
a
a
a
a
a
a
a
a
a
a
z
"}
(10,1,1) = {"
z
l
l
l
l
l
l
l
l
l
l
l
a
a
a
a
a
a
a
a
a
a
a
a
a
a
a
a
a
z
"}
(11,1,1) = {"
z
l
l
l
l
l
l
l
l
l
l
l
a
a
a
a
a
a
a
a
a
a
a
a
a
a
a
a
a
z
"}
(12,1,1) = {"
z
I
I
I
I
I
I
I
I
I
I
I
i
i
i
i
i
i
i
i
i
i
i
U
U
U
U
U
U
z
"}
(13,1,1) = {"
z
I
I
I
I
I
I
I
I
I
I
I
i
i
i
i
i
i
i
i
i
i
i
i
i
i
i
i
i
z
"}
(14,1,1) = {"
z
I
I
I
I
I
I
I
I
I
I
I
i
i
i
i
i
i
i
i
i
i
i
j
j
j
j
j
j
z
"}
(15,1,1) = {"
z
I
I
I
I
I
I
I
I
I
I
I
i
i
i
i
i
i
i
i
i
i
i
I
I
I
I
I
I
z
"}
(16,1,1) = {"
z
I
I
I
I
I
I
I
I
I
I
I
i
i
i
i
i
i
i
i
i
i
i
l
l
l
l
l
l
z
"}
(17,1,1) = {"
z
I
I
I
I
I
I
I
I
I
I
I
i
i
i
i
i
i
i
i
i
i
i
a
a
a
a
a
a
z
"}
(18,1,1) = {"
z
I
I
I
I
I
I
I
I
I
I
I
i
i
i
i
i
i
i
i
i
i
i
l
l
l
l
l
l
z
"}
(19,1,1) = {"
z
I
I
I
I
I
I
I
I
I
I
I
i
i
i
i
i
i
i
i
i
i
i
l
l
l
l
l
l
z
"}
(20,1,1) = {"
z
I
I
I
I
I
I
I
I
I
I
I
i
i
i
i
i
i
i
i
i
i
i
l
l
l
l
l
l
z
"}
(21,1,1) = {"
z
j
j
j
j
j
j
j
j
j
j
j
U
U
U
U
U
U
U
U
U
U
U
l
l
l
l
l
l
z
"}
(22,1,1) = {"
z
j
j
j
j
j
j
j
j
j
j
j
U
U
U
U
U
U
U
U
U
U
U
l
l
l
l
l
l
z
"}
(23,1,1) = {"
z
j
j
j
j
j
j
j
j
j
j
j
U
U
U
U
U
U
U
U
U
U
U
l
l
l
l
l
l
z
"}
(24,1,1) = {"
z
j
j
j
j
j
j
j
j
j
j
j
U
U
U
U
U
U
U
U
U
U
U
l
l
l
l
l
l
z
"}
(25,1,1) = {"
z
j
j
j
j
j
j
j
j
j
j
j
U
U
U
U
U
U
U
U
U
U
U
l
l
l
l
l
l
z
"}
(26,1,1) = {"
z
j
j
j
j
j
j
j
j
j
j
j
U
U
U
U
U
U
U
U
U
U
U
l
l
l
l
l
l
z
"}
(27,1,1) = {"
z
j
j
j
j
j
j
j
j
j
j
j
U
U
U
U
U
U
U
U
U
U
U
l
l
l
l
l
l
z
"}
(28,1,1) = {"
z
j
j
j
j
j
j
j
j
j
j
j
U
U
U
U
U
U
U
U
U
U
U
l
l
l
l
l
l
z
"}
(29,1,1) = {"
z
j
j
j
j
j
j
j
j
j
j
j
U
U
U
U
U
U
U
U
U
U
U
l
l
l
l
l
l
z
"}
(30,1,1) = {"
z
z
z
z
z
z
z
z
z
z
z
z
z
z
z
z
z
z
z
z
z
z
z
z
z
z
z
z
z
z
"}
